W = 20
H = 20
A00-A00-A00-A00-A00-A00-A00-A00-A10-A20-A30-A00-A00-A00-A00-A00-A00-A00-A00-A00
A00-A00-A00-A00-A00-A00-A00-A00-A40-A50-A60-A00-A00-A00-A00-A00-A00-A00-A00-A00
A00-A00-A00-A00-A00-A00-A00-A00-A40-A50-A60-A00-A00-A00-A00-A00-A00-A00-A00-A00
A00-A00-A00-A00-A00-A00-A00-A00-A40-A50-A60-A00-A00-A00-A00-A00-A00-A00-A00-A00
A00-A00-A00-A00-A00-A00-A00-A00-A40-A50-A60-A00-A00-A00-A00-A00-A00-A00-A00-A00
A00-A00-A00-A00-A00-A00-A00-A00-A40-A50-A60-A00-A00-A00-A00-A00-A00-A00-A00-A00
A00-A10-A20-A20-A20-A20-A20-A20-AA0-A50-A60-A00-A00-A00-A00-A00-A00-A00-A00-A00
A00-A40-A50-A50-A50-A50-A50-A50-A50-A50-A60-A00-A00-A00-A00-A00-A00-A00-A00-A00
A00-A70-A80-A80-A80-A80-A80-A80-A80-A80-A90-A00-A00-A00-A00-A00-A00-A00-A00-A00
A00-A00-A00-A00-A00-A00-A00-A00-A00-A00-A00-A00-A00-A00-A00-A00-A00-A00-A00-A00
A00-A00-A00-A00-A00-A00-A00-A00-A00-A00-A00-A00-A00-A00-A00-A00-A00-A00-A00-A00
A00-A00-A00-A00-A00-A00-A00-A00-A00-A00-A00-A00-A00-A00-A00-A00-A00-A00-A00-A00
A00-A00-A00-A00-A00-A00-A00-A00-A00-A00-A00-A00-A00-A00-A00-A00-A00-A00-A00-A00
A00-A00-A00-A00-A00-A00-A00-A00-A00-A00-A00-A00-A00-A00-A00-A00-A00-A00-A00-A00
A00-A00-A00-A00-A00-A00-A00-A00-A00-A00-A00-A00-A00-A00-A00-A00-A00-A00-A00-A00
A00-A00-A00-A00-A00-A00-A00-A00-A00-A00-A00-A00-A00-A00-A00-A00-A00-A00-A00-A00
A00-A00-A00-A00-A00-A00-A00-A00-A00-A00-A00-A00-A00-A00-A00-A00-A00-A00-A00-A00
A00-A00-A00-A00-A00-A00-A00-A00-A00-A00-A00-A00-A00-A00-A00-A00-A00-A00-A00-A00
A00-A00-A00-A00-A00-A00-A00-A00-A00-A00-A00-A00-A00-A00-A00-A00-A00-A00-A00-A00
A00-A00-A00-A00-A00-A00-A00-A00-A00-A00-A00-A00-A00-A00-A00-A00-A00-A00-A00-A00