W = 40
H = 40
1A1-1E1-1E1-1E1-1E1-1E1-1E1-1E1-1E1-1E1-1E1-1E1-1E1-1E1-1E1-1E1-1E1-1E1-1E1-1E1-1E1-1E1-1E1-1E1-1E1-1E1-1E1-1E1-1E1-1E1-1E1-1E1-1E1-1E1-1E1-1E1-1E1-1E1-1E1-1B1
1H1-110-150-150-150-150-150-150-150-150-150-150-150-150-150-150-150-150-150-150-150-150-150-150-150-150-150-150-150-150-150-150-150-150-150-150-150-150-120-1F1
1H1-180-190-190-190-190-190-190-190-190-190-190-190-190-190-190-190-190-190-190-190-190-190-190-190-190-190-190-190-190-190-190-190-190-190-190-190-190-160-1F1
1H1-180-190-190-190-190-190-190-190-190-190-190-190-190-190-190-190-190-190-190-190-190-190-190-190-190-190-190-190-190-190-190-190-190-190-190-190-190-160-1F1
1H1-180-190-190-190-190-190-190-190-190-190-190-190-190-190-190-190-190-190-190-190-190-190-190-190-190-190-190-190-190-190-190-190-190-190-190-190-190-160-1F1
1H1-180-190-190-190-190-190-190-190-190-190-190-190-190-190-190-190-190-190-190-190-190-190-190-190-190-190-190-190-190-190-190-190-190-190-190-190-190-160-1F1
1H1-180-190-190-190-190-190-190-190-190-190-190-190-190-190-190-190-190-190-190-190-190-190-190-190-190-190-190-190-190-190-190-190-190-190-190-190-190-160-1F1
1H1-180-190-190-190-190-190-190-190-190-190-190-190-190-190-190-190-190-190-190-190-190-190-190-190-190-190-190-190-190-190-190-190-190-190-190-190-190-160-1F1
1H1-180-190-190-190-190-190-190-190-190-190-190-190-190-190-190-190-190-190-190-190-190-190-190-190-190-190-190-190-190-190-190-190-190-190-190-190-190-160-1F1
1H1-180-190-190-190-190-190-190-190-190-190-190-190-190-190-190-190-190-190-190-190-190-190-190-190-190-190-190-190-190-190-190-190-190-190-190-190-190-160-1F1
1H1-180-190-190-190-190-190-190-190-190-190-190-190-190-190-190-190-190-190-190-190-190-190-190-190-190-190-190-190-190-190-190-190-190-190-190-190-190-160-1F1
1H1-180-190-190-190-190-190-190-190-190-190-190-190-190-190-190-190-190-190-190-190-190-190-190-190-190-190-190-190-190-190-190-190-190-190-190-190-190-160-1F1
1H1-180-190-190-190-190-190-190-190-190-190-190-190-190-190-190-190-190-190-190-190-190-190-190-190-190-190-190-190-190-190-190-190-190-190-190-190-190-160-1F1
1H1-180-190-190-190-190-190-190-190-190-190-190-190-190-190-190-190-190-190-190-190-190-190-190-190-190-190-190-190-190-190-190-190-190-190-190-190-190-160-1F1
1H1-180-190-190-190-190-190-190-190-190-190-190-190-190-190-190-190-190-190-190-190-190-190-190-190-190-190-190-190-190-190-190-190-190-190-190-190-190-160-1F1
1H1-180-190-190-190-190-190-190-190-190-190-190-190-190-190-190-190-190-190-190-190-190-190-190-190-190-190-190-190-190-190-190-190-190-190-190-190-190-160-1F1
1H1-180-190-190-190-190-190-190-190-190-190-190-190-190-190-190-190-190-190-190-190-190-190-190-190-190-190-190-190-190-190-190-190-190-190-190-190-190-160-1F1
1H1-180-190-190-190-190-190-190-190-190-190-190-190-190-190-190-190-190-190-190-190-190-190-190-190-190-190-190-190-190-190-190-190-190-190-190-190-190-160-1F1
1H1-180-190-190-190-190-190-190-190-190-190-190-190-190-190-190-190-190-190-190-190-190-190-190-190-190-190-190-190-190-190-190-190-190-190-190-190-190-160-1F1
1H1-180-190-190-190-190-190-190-190-190-190-190-190-190-190-190-190-190-190-190-190-190-190-190-190-190-190-190-190-190-190-190-190-190-190-190-190-190-160-1F1
1H1-180-190-190-190-190-190-190-190-190-190-190-190-190-190-190-190-190-190-190-190-190-190-190-190-190-190-190-190-190-190-190-190-190-190-190-190-190-160-1F1
1H1-180-190-190-190-190-190-190-190-190-190-190-190-190-190-190-190-190-190-190-190-190-190-190-190-190-190-190-190-190-190-190-190-190-190-190-190-190-160-1F1
1H1-180-190-190-190-190-190-190-190-190-190-190-190-190-190-190-190-190-190-190-190-190-190-190-190-190-190-190-190-190-190-190-190-190-190-190-190-190-160-1F1
1H1-180-190-190-190-190-190-190-190-190-190-190-190-190-190-190-190-190-190-190-190-190-190-190-190-190-190-190-190-190-190-190-190-190-190-190-190-190-160-1F1
1H1-180-190-190-190-190-190-190-190-190-190-190-190-190-190-190-190-190-190-190-190-190-190-190-190-190-190-190-190-190-190-190-190-190-190-190-190-190-160-1F1
1H1-180-190-190-190-190-190-190-190-190-190-190-190-190-190-190-190-190-190-190-190-190-190-190-190-190-190-190-190-190-190-190-190-190-190-190-190-190-160-1F1
1H1-180-190-190-190-190-190-190-190-190-190-190-190-190-190-190-190-190-190-190-190-190-190-190-190-190-190-190-190-190-190-190-190-190-190-190-190-190-160-1F1
1H1-180-190-190-190-190-190-190-190-190-190-190-190-190-190-190-190-190-190-190-190-190-190-190-190-190-190-190-190-190-190-190-190-190-190-190-190-190-160-1F1
1H1-180-190-190-190-190-190-190-190-190-190-190-190-190-190-190-190-190-190-190-190-190-190-190-190-190-190-190-190-190-190-190-190-190-190-190-190-190-160-1F1
1H1-180-190-190-190-190-190-190-190-190-190-190-190-190-190-190-190-190-190-190-190-190-190-190-190-190-190-190-190-190-190-190-190-190-190-190-190-190-160-1F1
1H1-180-190-190-190-190-190-190-190-190-190-190-190-190-190-190-190-190-190-190-190-190-190-190-190-190-190-190-190-190-190-190-190-190-190-190-190-190-160-1F1
1H1-180-190-190-190-190-190-190-190-190-190-190-190-190-190-190-190-190-190-190-190-190-190-190-190-190-190-190-190-190-190-190-190-190-190-190-190-190-160-1F1
1H1-180-190-190-190-190-190-190-190-190-190-190-190-190-190-190-190-190-190-190-190-190-190-190-190-190-190-190-190-190-190-190-190-190-190-190-190-190-160-1F1
1H1-180-190-190-190-190-190-190-190-190-190-190-190-190-190-190-190-190-190-190-190-190-190-190-190-190-190-190-190-190-190-190-190-190-190-190-190-190-160-1F1
1H1-180-190-190-190-190-190-190-190-190-190-190-190-190-190-190-190-190-190-190-190-190-190-190-190-190-190-190-190-190-190-190-190-190-190-190-190-190-160-1F1
1H1-180-190-190-190-190-190-190-190-190-190-190-190-190-190-190-190-190-190-190-190-190-190-190-190-190-190-190-190-190-190-190-190-190-190-190-190-190-160-1F1
1H1-180-190-190-190-190-190-190-190-190-190-190-190-190-190-190-190-190-190-190-190-190-190-190-190-190-190-190-190-190-190-190-190-190-190-190-190-190-160-1F1
1H1-180-190-190-190-190-190-190-190-190-190-190-190-190-190-190-190-190-190-190-190-190-190-190-190-190-190-190-190-190-190-190-190-190-190-190-190-190-160-1F1
1H1-130-170-170-170-170-170-170-170-170-170-170-170-170-170-170-170-170-170-170-170-170-170-170-170-170-170-170-170-170-170-170-170-170-170-170-170-170-140-1F1
1C1-1G1-1G1-1G1-1G1-1G1-1G1-1G1-1G1-1G1-1G1-1G1-1G1-1G1-1G1-1G1-1G1-1G1-1G1-1G1-1G1-1G1-1G1-1G1-1G1-1G1-1G1-1G1-1G1-1G1-1G1-1G1-1G1-1G1-1G1-1G1-1G1-1G1-1G1-1D1