40x40/
1A-1E-1E-1E-1E-1E-1E-1E-1E-1E-1E-1E-1E-1E-1E-1E-1E-1E-1E-1E-1E-1E-1E-1E-1E-1E-1E-1E-1E-1E-1E-1E-1E-1E-1E-1E-1E-1E-1E-1B/
1H-11-15-15-15-15-15-15-15-15-15-15-15-15-15-15-15-15-15-15-15-15-15-15-15-15-15-15-15-15-15-15-15-15-15-15-15-15-12-1F/
1H-18-19-19-19-19-19-19-19-19-19-19-19-19-19-19-19-19-19-19-19-19-19-19-19-19-19-19-19-19-19-19-19-19-19-19-19-19-16-1F/
1H-18-19-19-19-19-19-19-19-19-19-19-19-19-19-19-19-19-19-19-19-19-19-19-19-19-19-19-19-19-19-19-19-19-19-19-19-19-16-1F/
1H-18-19-19-19-19-19-19-19-19-19-19-19-19-19-19-19-19-19-19-19-19-19-19-19-19-19-19-19-19-19-19-19-19-19-19-19-19-16-1F/
1H-18-19-19-19-19-19-19-19-19-19-19-19-19-19-19-19-19-19-19-19-19-19-19-19-19-19-19-19-19-19-19-19-19-19-19-19-19-16-1F/
1H-18-19-19-19-19-19-19-19-19-19-19-19-19-19-19-19-19-19-19-19-19-19-19-19-19-19-19-19-19-19-19-19-19-19-19-19-19-16-1F/
1H-18-19-19-19-19-19-19-19-19-19-19-19-19-19-19-19-19-19-19-19-19-19-19-19-19-19-19-19-19-19-19-19-19-19-19-19-19-16-1F/
1H-18-19-19-19-19-19-19-19-19-19-19-19-19-19-19-19-19-19-19-19-19-19-19-19-19-19-19-19-19-19-19-19-19-19-19-19-19-16-1F/
1H-18-19-19-19-19-19-19-19-19-19-19-19-19-19-19-19-19-19-19-19-19-19-19-19-19-19-19-19-19-19-19-19-19-19-19-19-19-16-1F/
1H-18-19-19-19-19-19-19-19-19-19-19-19-19-19-19-19-19-19-19-19-19-19-19-19-19-19-19-19-19-19-19-19-19-19-19-19-19-16-1F/
1H-18-19-19-19-19-19-19-19-19-19-19-19-19-19-19-19-19-19-19-19-19-19-19-19-19-19-19-19-19-19-19-19-19-19-19-19-19-16-1F/
1H-18-19-19-19-19-19-19-19-19-19-19-19-19-19-19-19-19-19-19-19-19-19-19-19-19-19-19-19-19-19-19-19-19-19-19-19-19-16-1F/
1H-18-19-19-19-19-19-19-19-19-19-19-19-19-19-19-19-19-19-19-19-19-19-19-19-19-19-19-19-19-19-19-19-19-19-19-19-19-16-1F/
1H-18-19-19-19-19-19-19-19-19-19-19-19-19-19-19-19-19-19-19-19-19-19-19-19-19-19-19-19-19-19-19-19-19-19-19-19-19-16-1F/
1H-18-19-19-19-19-19-19-19-19-19-19-19-19-19-19-19-19-19-19-19-19-19-19-19-19-19-19-19-19-19-19-19-19-19-19-19-19-16-1F/
1H-18-19-19-19-19-19-19-19-19-19-19-19-19-19-19-19-19-19-19-19-19-19-19-19-19-19-19-19-19-19-19-19-19-19-19-19-19-16-1F/
1H-18-19-19-19-19-19-19-19-19-19-19-19-19-19-19-19-19-19-19-19-19-19-19-19-19-19-19-19-19-19-19-19-19-19-19-19-19-16-1F/
1H-18-19-19-19-19-19-19-19-19-19-19-19-19-19-19-19-19-19-19-19-19-19-19-19-19-19-19-19-19-19-19-19-19-19-19-19-19-16-1F/
1H-18-19-19-19-19-19-19-19-19-19-19-19-19-19-19-19-19-19-19-19-19-19-19-19-19-19-19-19-19-19-19-19-19-19-19-19-19-16-1F/
1H-18-19-19-19-19-19-19-19-19-19-19-19-19-19-19-19-19-19-19-19-19-19-19-19-19-19-19-19-19-19-19-19-19-19-19-19-19-16-1F/
1H-18-19-19-19-19-19-19-19-19-19-19-19-19-19-19-19-19-19-19-19-19-19-19-19-19-19-19-19-19-19-19-19-19-19-19-19-19-16-1F/
1H-18-19-19-19-19-19-19-19-19-19-19-19-19-19-19-19-19-19-19-19-19-19-19-19-19-19-19-19-19-19-19-19-19-19-19-19-19-16-1F/
1H-18-19-19-19-19-19-19-19-19-19-19-19-19-19-19-19-19-19-19-19-19-19-19-19-19-19-19-19-19-19-19-19-19-19-19-19-19-16-1F/
1H-18-19-19-19-19-19-19-19-19-19-19-19-19-19-19-19-19-19-19-19-19-19-19-19-19-19-19-19-19-19-19-19-19-19-19-19-19-16-1F/
1H-18-19-19-19-19-19-19-19-19-19-19-19-19-19-19-19-19-19-19-19-19-19-19-19-19-19-19-19-19-19-19-19-19-19-19-19-19-16-1F/
1H-18-19-19-19-19-19-19-19-19-19-19-19-19-19-19-19-19-19-19-19-19-19-19-19-19-19-19-19-19-19-19-19-19-19-19-19-19-16-1F/
1H-18-19-19-19-19-19-19-19-19-19-19-19-19-19-19-19-19-19-19-19-19-19-19-19-19-19-19-19-19-19-19-19-19-19-19-19-19-16-1F/
1H-18-19-19-19-19-19-19-19-19-19-19-19-19-19-19-19-19-19-19-19-19-19-19-19-19-19-19-19-19-19-19-19-19-19-19-19-19-16-1F/
1H-18-19-19-19-19-19-19-19-19-19-19-19-19-19-19-19-19-19-19-19-19-19-19-19-19-19-19-19-19-19-19-19-19-19-19-19-19-16-1F/
1H-18-19-19-19-19-19-19-19-19-19-19-19-19-19-19-19-19-19-19-19-19-19-19-19-19-19-19-19-19-19-19-19-19-19-19-19-19-16-1F/
1H-18-19-19-19-19-19-19-19-19-19-19-19-19-19-19-19-19-19-19-19-19-19-19-19-19-19-19-19-19-19-19-19-19-19-19-19-19-16-1F/
1H-18-19-19-19-19-19-19-19-19-19-19-19-19-19-19-19-19-19-19-19-19-19-19-19-19-19-19-19-19-19-19-19-19-19-19-19-19-16-1F/
1H-18-19-19-19-19-19-19-19-19-19-19-19-19-19-19-19-19-19-19-19-19-19-19-19-19-19-19-19-19-19-19-19-19-19-19-19-19-16-1F/
1H-18-19-19-19-19-19-19-19-19-19-19-19-19-19-19-19-19-19-19-19-19-19-19-19-19-19-19-19-19-19-19-19-19-19-19-19-19-16-1F/
1H-18-19-19-19-19-19-19-19-19-19-19-19-19-19-19-19-19-19-19-19-19-19-19-19-19-19-19-19-19-19-19-19-19-19-19-19-19-16-1F/
1H-18-19-19-19-19-19-19-19-19-19-19-19-19-19-19-19-19-19-19-19-19-19-19-19-19-19-19-19-19-19-19-19-19-19-19-19-19-16-1F/
1H-18-19-19-19-19-19-19-19-19-19-19-19-19-19-19-19-19-19-19-19-19-19-19-19-19-19-19-19-19-19-19-19-19-19-19-19-19-16-1F/
1H-13-17-17-17-17-17-17-17-17-17-17-17-17-17-17-17-17-17-17-17-17-17-17-17-17-17-17-17-17-17-17-17-17-17-17-17-17-14-1F/
1C-1G-1G-1G-1G-1G-1G-1G-1G-1G-1G-1G-1G-1G-1G-1G-1G-1G-1G-1G-1G-1G-1G-1G-1G-1G-1G-1G-1G-1G-1G-1G-1G-1G-1G-1G-1G-1G-1G-1D/